[
  {
    "type": "mapgen",
    "method": "json",
    "om_terrain": [ "s_city" ],
    "object": {
      "fill_ter": "t_dirt",
      "rows": [
        "                        ",
        "                        ",
        "                        ",
        "                        ",
        "                        ",
        "                        ",
        "                        ",
        "                        ",
        "                        ",
        "      #######o          ",
        "      #=uu#u=t          ",
        "      w=l=#u=o          ",
        "      wltl#u=t          ",
        "      #=l=#==o          ",
        "      +=Z=+===          ",
        "      ########          ",
        "                        ",
        "                        ",
        "                        ",
        "                        ",
        "                        ",
        "                        ",
        "                        ",
        "                        "
      ],
    "palettes": [ "city_building_palette" ],
	      "place_nested": [
        {
          "chunks": [ ["shop_generic_8x8", 1], ["paupers_house_8x8", 1] ],
          "x": 0,
          "y": 0
        },
        {
          "chunks": [ ["shop_generic_8x8", 1], ["paupers_house_8x8", 1] ],
          "x": 8,
          "y": 0
        },
        {
          "chunks": [ ["shop_generic_8x8", 1], ["paupers_house_8x8", 1] ],
          "x": 16,
          "y": 0
        }
      ]
    }
  },
  {
    "type": "mapgen",
    "method": "json",
    "om_terrain": [ "housing_district_1^0" ],
    "object": {
      "fill_ter": "t_dirt",
      "rows": [
        "........................",
        ".##w##w###ww###w##w##w#.",
        ".w******#****#********#.",
        ".#******#****#********w.",
        ".w******#****#********#.",
        ".#*H****#****#********#.",
        ".w******##+#w#**H*****w.",
        ".#******#....#********#.",
        ".##w#+###....w********#.",
        ".............##+#######.",
        ".######..........#****#.",
        ".w****#..........w****w.",
        ".#****+..........+****#.",
        ".w****w..........#****w.",
        ".#****#..........######.",
        ".######w#...............",
        ".#******+...............",
        ".w******###w##..###+###.",
        ".#****H*#****w..#*****#.",
        ".#******#****#..w*H***w.",
        ".w******#****+..#*****#.",
        ".#******#****#..#*****#.",
        ".##w##w####w##..###w###.",
        "........................"
      ],
    "palettes": [ "city_building_palette" ]
	}
  },
  {
    "type": "mapgen",
    "method": "json",
    "om_terrain": [ "housing_district_1^1" ],
    "object": {
      "fill_ter": "t_open_air",
      "rows": [
        "%%%%%%%%%%%%%%%%%%%%%%%%",
        "%rrrrrrrrrrrrrrrrrrrrrr%",
        "%r##ww##rrrrrr##w##w##r%",
        "%r#====#rrrrrr#======#r%",
        "%r#====#rrrrrr#======#r%",
        "%r#I%%%#rrrrrr#======#r%",
        "%r#%%%%#rrrrrr#%I%%%%#r%",
        "%r######r%%%%r#%%%%%%#r%",
        "%rrrrrrrr%%%%r########r%",
        "%%%%%%%%%%%%%rrrrrrrrrr%",
        "%rrrrrr%%%%%%%%%%rrrrrr%",
        "%rrrrrr%%%%%%%%%%rrrrrr%",
        "%rrrrrr%%%%%%%%%%rrrrrr%",
        "%rrrrrr%%%%%%%%%%rrrrrr%",
        "%rrrrrr%%%%%%%%%%rrrrrr%",
        "%rrrrrrrr%%%%%%%%%%%%%%%",
        "%r######r%%%%%%%%%%%%%%%",
        "%r#%%%%#rrrrrr%%rrrrrrr%",
        "%r#%%%I#rrrrrr%%r#####r%",
        "%r#====#rrrrrr%%rwI==wr%",
        "%r#====#rrrrrr%%r#===#r%",
        "%r###w##rrrrrr%%r##w##r%",
        "%rrrrrrrrrrrrr%%rrrrrrr%",
        "%%%%%%%%%%%%%%%%%%%%%%%%"
      ],
    "palettes": [ "city_building_palette" ]
	}
  },
  {
    "type": "mapgen",
    "method": "json",
    "om_terrain": [ "housing_district_1^2" ],
    "object": {
      "fill_ter": "t_open_air",
      "rows": [
        "%%%%%%%%%%%%%%%%%%%%%%%%",
        "%%%%%%%%%%%%%%%%%%%%%%%%",
        "%%rrrrrr%%%%%%rrrrrrrr%%",
        "%%rrrrrr%%%%%%rrrrrrrr%%",
        "%%rrrrrr%%%%%%rrrrrrrr%%",
        "%%rrrrrr%%%%%%rrrrrrrr%%",
        "%%rrrrrr%%%%%%rrrrrrrr%%",
        "%%rrrrrr%%%%%%rrrrrrrr%%",
        "%%%%%%%%%%%%%%rrrrrrrr%%",
        "%%%%%%%%%%%%%%%%%%%%%%%%",
        "%%%%%%%%%%%%%%%%%%%%%%%%",
        "%%%%%%%%%%%%%%%%%%%%%%%%",
        "%%%%%%%%%%%%%%%%%%%%%%%%",
        "%%%%%%%%%%%%%%%%%%%%%%%%",
        "%%%%%%%%%%%%%%%%%%%%%%%%",
        "%%%%%%%%%%%%%%%%%%%%%%%%",
        "%%rrrrrr%%%%%%%%%%%%%%%%",
        "%%rrrrrr%%%%%%%%%%%%%%%%",
        "%%rrrrrr%%%%%%%%%rrrrr%%",
        "%%rrrrrr%%%%%%%%%rrrrr%%",
        "%%rrrrrr%%%%%%%%%rrrrr%%",
        "%%rrrrrr%%%%%%%%%rrrrr%%",
        "%%%%%%%%%%%%%%%%%%%%%%%%",
        "%%%%%%%%%%%%%%%%%%%%%%%%"
      ],
    "palettes": [ "city_building_palette" ]
  }
  }
]
