[
  {
    "type": "mapgen",
    "method": "json",
    "om_terrain": [ "main_road_straight" ],
    "weight": 100,
    "object": {
      "fill_ter": "t_dirt",
      "predecessor_mapgen": "field",
      "rows": [
        ".......i///ii///i.......",
        ".......i///ii///i.......",
        ".......i///ii///i.......",
        ".......i///ii///i.......",
        ".......i///ii///i.......",
        ".......i///ii///i.......",
        ".......i///ii///i.......",
        "......i///ii////i.......",
        "......i///ii////i.......",
        "......i///ii///i........",
        "......i///ii///i........",
        "......i///ii///i........",
        "......i///ii///i........",
        "......i///ii///i........",
        "......i///ii///i........",
        "......i///ii///i........",
        "......i////ii///i.......",
        "......i////ii///i.......",
        ".......i///ii///i.......",
        ".......i///ii///i.......",
        ".......i///ii///i.......",
        ".......i///ii///i.......",
        ".......i///ii///i.......",
        ".......i///ii///i......."
      ],
      "flags": [ "ERASE_ALL_BEFORE_PLACING_TERRAIN" ],
      "palettes": [ "rural_road" ],
      "place_nested": [ { "chunks": [ [ "2x2_haybale", 5 ], [ "null", 20 ] ], "x": [ 4, 18 ], "y": [ 0, 22 ] } ]
    }
  },
  {
    "type": "mapgen",
    "method": "json",
    "om_terrain": [ "main_road_straight" ],
    "weight": 100,
    "object": {
      "fill_ter": "t_dirt",
      "predecessor_mapgen": "field",
      "rows": [
        ".......i///ii///i.......",
        ".......i///ii///i.......",
        ".......i///ii///i.......",
        ".......i///ii///i.......",
        ".......i///ii///i.......",
        "........i///ii///i......",
        "........i///ii///i......",
        "........i///ii///i......",
        "........i///ii///i......",
        "........i///ii///i......",
        "........i///ii///i......",
        ".........i///ii///i.....",
        ".........i///ii///i.....",
        ".........i///ii///i.....",
        ".........i///ii///i.....",
        "........i///ii///i......",
        "........i///ii///i......",
        "........i///ii///i......",
        "........i///ii///i......",
        ".......i///ii///i.......",
        ".......i///ii///i.......",
        ".......i///ii///i.......",
        ".......i///ii///i.......",
        ".......i///ii///i......."
      ],
      "flags": [ "ERASE_ALL_BEFORE_PLACING_TERRAIN" ],
      "palettes": [ "rural_road" ],
      "place_nested": [ { "chunks": [ [ "2x2_haybale", 5 ], [ "null", 20 ] ], "x": [ 4, 18 ], "y": [ 0, 22 ] } ]
    }
  },
  {
    "type": "mapgen",
    "method": "json",
    "om_terrain": [ "main_road_end" ],
    "weight": 100,
    "object": {
      "fill_ter": "t_dirt",
      "predecessor_mapgen": "field",
      "rows": [
        ".......i///ii///i.......",
        ".......i///ii///i.......",
        ".......i///ii///i.......",
        ".......i///ii///i.......",
        ".......i///ii///i.......",
        "........i///ii///i......",
        "........i///ii///i......",
        "........i///ii///i......",
        "........i///ii///i......",
        "........i///ii///i......",
        "........i///ii///i......",
        ".........i///ii///i.....",
        ".........i///ii///i.....",
        ".........i///ii///i.....",
        ".........i///ii///i.....",
        "........i///ii///i......",
        "........i///ii///i......",
        "........i///ii///i......",
        "........i///ii///i......",
        ".......i///ii///i.......",
        ".......i///ii///i.......",
        ".......i///ii///i.......",
        ".......i///ii///i.......",
        ".......i///ii///i......."
      ],
      "flags": [ "ERASE_ALL_BEFORE_PLACING_TERRAIN" ],
      "palettes": [ "rural_road" ],
      "place_nested": [ { "chunks": [ [ "2x2_haybale", 5 ], [ "null", 20 ] ], "x": [ 4, 18 ], "y": [ 0, 22 ] } ]
    }
  },
  {
    "type": "mapgen",
    "method": "json",
    "om_terrain": [ "main_road_tee" ],
    "weight": 100,
    "object": {
      "fill_ter": "t_dirt",
      "predecessor_mapgen": "field",
      "rotation": [ 1, 1 ],
      "rows": [
        ".......i///ii///i.......",
        ".......i///ii///i.......",
        ".......i///ii///i.......",
        ".......i///ii///i.......",
        ".......i///ii///i.......",
        ".......i///ii///i.......",
        ".......i///ii///i.......",
        "......i////ii///iiiiiiii",
        "......i////ii///////////",
        "......i////ii///////////",
        "......i//////ii/////////",
        "......i/////iiiiiiiiiiii",
        "......i/////iiiiiiiiiiii",
        "......i//////ii/////////",
        "......i/////ii//////////",
        "......i////ii///////////",
        "......i////ii///iiiiiiii",
        "......i////ii///i.......",
        ".......i///ii///i.......",
        ".......i///ii///i.......",
        ".......i///ii///i.......",
        ".......i///ii///i.......",
        ".......i///ii///i.......",
        ".......i///ii///i......."
      ],
      "flags": [ "ERASE_ALL_BEFORE_PLACING_TERRAIN" ],
      "palettes": [ "rural_road" ],
      "place_nested": [ { "chunks": [ [ "2x2_haybale", 5 ], [ "null", 20 ] ], "x": [ 10, 20 ], "y": [ 0, 22 ] } ]
    }
  },
  {
    "type": "mapgen",
    "method": "json",
    "om_terrain": [ "main_road_curved" ],
    "weight": 100,
    "object": {
      "fill_ter": "t_dirt",
      "predecessor_mapgen": "field",
      "rows": [
        "........................",
        "........................",
        "........................",
        "........................",
        "........................",
        "........................",
        "........................",
        "..............iiiiiiiiii",
        "...........iiii/////////",
        "..........i/////////////",
        ".........i//////////////",
        "........i//////iiiiiiiii",
        "........i/////iiiiiiiiii",
        "........i/////ii////////",
        "........i/////ii////////",
        "........i////ii/////////",
        "........i///ii////iiiiii",
        ".......i///ii////i......",
        ".......i///ii///i.......",
        ".......i///ii///i.......",
        ".......i///ii///i.......",
        ".......i///ii///i.......",
        ".......i///ii///i.......",
        ".......i///ii///i......."
      ],
      "flags": [ "ERASE_ALL_BEFORE_PLACING_TERRAIN" ],
      "palettes": [ "rural_road" ]
    }
  },
  {
    "type": "mapgen",
    "method": "json",
    "om_terrain": [ "main_road_four_way" ],
    "weight": 100,
    "object": {
      "fill_ter": "t_dirt",
      "predecessor_mapgen": "field",
      "rows": [
        ".......i///ii///i.......",
        ".......i///ii///i.......",
        ".......i///ii///i.......",
        ".......i///ii///i.......",
        ".......i///ii///i.......",
        ".......i///ii///i.......",
        ".......i///ii////i......",
        ".......i///ii////iiiiiii",
        "iiiiiii/////////////////",
        "////////////////////////",
        "////////////////////////",
        "iiiiiiii///ii///iiiiiiii",
        "iiiiiiii///ii///iiiiiiii",
        "////////////////////////",
        "////////////////////////",
        "////////////////////////",
        "iiiiiii////ii////iiiiiii",
        ".......i///ii////i......",
        ".......i///ii///i.......",
        ".......i///ii///i.......",
        "........i//ii////i......",
        "........i//ii////i......",
        "........i//ii////i......",
        ".......i///ii///i......."
      ],
      "flags": [ "ERASE_ALL_BEFORE_PLACING_TERRAIN" ],
      "palettes": [ "rural_road" ]
    }
  },
  {
    "type": "mapgen",
    "method": "json",
    "om_terrain": [ "main_road_forest_straight" ],
    "weight": 100,
    "object": {
      "fill_ter": "t_dirt",
      "predecessor_mapgen": "forest",
      "rows": [
        ".......i///ii///i.......",
        ".......i///ii///i.......",
        ".......i///ii///i.......",
        ".......i///ii///i.......",
        ".......i///ii///i.......",
        ".......i///ii///i.......",
        ".......i///ii///i.......",
        "......i///ii////i.......",
        "......i///ii////i.......",
        "......i///ii///i........",
        "......i///ii///i........",
        "......i///ii///i........",
        "......i///ii///i........",
        "......i///ii///i........",
        "......i///ii///i........",
        "......i///ii///i........",
        "......i////ii///i.......",
        "......i////ii///i.......",
        ".......i///ii///i.......",
        ".......i///ii///i.......",
        ".......i///ii///i.......",
        ".......i///ii///i.......",
        ".......i///ii///i.......",
        ".......i///ii///i......."
      ],
      "flags": [ "ERASE_ALL_BEFORE_PLACING_TERRAIN" ],
      "palettes": [ "rural_road" ]
    }
  },
  {
    "type": "mapgen",
    "method": "json",
    "om_terrain": [ "main_road_forest_end" ],
    "weight": 100,
    "object": {
      "fill_ter": "t_dirt",
      "predecessor_mapgen": "forest",
      "rows": [
        ".......i///ii///i.......",
        ".......i///ii///i.......",
        ".......i///ii///i.......",
        ".......i///ii///i.......",
        ".......i///ii///i.......",
        "........i///ii///i......",
        "........i///ii///i......",
        "........i///ii///i......",
        "........i///ii///i......",
        "........i///ii///i......",
        "........i///ii///i......",
        ".........i///ii///i.....",
        ".........i///ii///i.....",
        ".........i///ii///i.....",
        ".........i///ii///i.....",
        "........i///ii///i......",
        "........i///ii///i......",
        "........i///ii///i......",
        "........i///ii///i......",
        ".......i///ii///i.......",
        ".......i///ii///i.......",
        ".......i///ii///i.......",
        ".......i///ii///i.......",
        ".......i///ii///i......."
      ],
      "flags": [ "ERASE_ALL_BEFORE_PLACING_TERRAIN" ],
      "palettes": [ "rural_road" ]
    }
  },
  {
    "type": "mapgen",
    "method": "json",
    "om_terrain": [ "main_road_forest_curved" ],
    "weight": 100,
    "object": {
      "fill_ter": "t_dirt",
      "predecessor_mapgen": "forest",
      "rows": [
        "........................",
        "........................",
        "........................",
        "........................",
        "........................",
        "........................",
        "........................",
        "..............iiiiiiiiii",
        "...........iiii/////////",
        "..........i/////////////",
        ".........i//////////////",
        "........i//////iiiiiiiii",
        "........i/////iiiiiiiiii",
        "........i/////ii////////",
        "........i/////ii////////",
        "........i////ii/////////",
        "........i///ii////iiiiii",
        ".......i///ii////i......",
        ".......i///ii///i.......",
        ".......i///ii///i.......",
        ".......i///ii///i.......",
        ".......i///ii///i.......",
        ".......i///ii///i.......",
        ".......i///ii///i......."
      ],
      "flags": [ "ERASE_ALL_BEFORE_PLACING_TERRAIN" ],
      "palettes": [ "rural_road" ]
    }
  },
  {
    "type": "mapgen",
    "method": "json",
    "om_terrain": [ "main_road_forest_four_way" ],
    "weight": 100,
    "object": {
      "fill_ter": "t_dirt",
      "predecessor_mapgen": "forest",
      "rows": [
        ".......i///ii///i.......",
        ".......i///ii///i.......",
        ".......i///ii///i.......",
        ".......i///ii///i.......",
        ".......i///ii///i.......",
        ".......i///ii///i.......",
        ".......i///ii////i......",
        ".......i///ii////iiiiiii",
        "iiiiiii/////////////////",
        "////////////////////////",
        "////////////////////////",
        "iiiiiiii///ii///iiiiiiii",
        "iiiiiiii///ii///iiiiiiii",
        "////////////////////////",
        "////////////////////////",
        "////////////////////////",
        "iiiiiii////ii////iiiiiii",
        ".......i///ii////i......",
        ".......i///ii///i.......",
        ".......i///ii///i.......",
        "........i//ii////i......",
        "........i//ii////i......",
        "........i//ii////i......",
        ".......i///ii///i......."
      ],
      "flags": [ "ERASE_ALL_BEFORE_PLACING_TERRAIN" ],
      "palettes": [ "rural_road" ]
    }
  },
  {
    "type": "mapgen",
    "method": "json",
    "om_terrain": [ "main_road_forest_tee" ],
    "weight": 100,
    "object": {
      "fill_ter": "t_dirt",
      "predecessor_mapgen": "forest",
      "rotation": [ 1, 1 ],
      "rows": [
        ".......i///ii///i.......",
        ".......i///ii///i.......",
        ".......i///ii///i.......",
        ".......i///ii///i.......",
        ".......i///ii///i.......",
        ".......i///ii///i.......",
        ".......i///ii///i.......",
        "......i////ii///iiiiiiii",
        "......i////ii///////////",
        "......i////ii///////////",
        "......i//////ii/////////",
        "......i/////iiiiiiiiiiii",
        "......i/////iiiiiiiiiiii",
        "......i//////ii/////////",
        "......i/////ii//////////",
        "......i////ii///////////",
        "......i////ii///iiiiiiii",
        "......i////ii///i.......",
        ".......i///ii///i.......",
        ".......i///ii///i.......",
        ".......i///ii///i.......",
        ".......i///ii///i.......",
        ".......i///ii///i.......",
        ".......i///ii///i......."
      ],
      "flags": [ "ERASE_ALL_BEFORE_PLACING_TERRAIN" ],
      "palettes": [ "rural_road" ]
    }
  },
  {
    "type": "mapgen",
    "method": "json",
    "om_terrain": "special_field",
    "object": { "predecessor_mapgen": "field" }
  },
  {
    "type": "mapgen",
    "method": "json",
    "om_terrain": "special_forest",
    "object": { "predecessor_mapgen": "forest" }
  },
  {
    "type": "mapgen",
    "method": "json",
    "om_terrain": "special_forest_thick",
    "object": { "predecessor_mapgen": "forest_thick" }
  }
]
