[
  {
    "method": "json",
    "object": {
      "rows": [
        "........................",
        "........................",
        "........................",
        "........................",
        "........................",
        "........................",
        "........................",
        "........................",
        "........................",
        "........................",
        "........................",
        "........................",
        "........................",
        "........................",
        "........................",
        "........................",
        "........................",
        "........................",
        "........................",
        "........................",
        "........................",
        "........................",
        "........................",
        "........................"
      ],
      "terrain": { ".": "t_soil" }
    },
    "om_terrain": "solid_earth",
    "type": "mapgen",
    "weight": 100
  },
  {
    "method": "json",
    "object": {
      "predecessor_mapgen": "field",
      "rows": [
        "#####################UUU",
        "UU##########UUU###UUUuuu",
        "uuUUU####UUUuuuUUUuuu   ",
        "  uuuUUUUuuu   uuu      ",
        "     uuuu               ",
        "                        ",
        "                        ",
        "                        ",
        "                        ",
        "                        ",
        "                        ",
        "                        ",
        "                        ",
        "                        ",
        "                        ",
        "                        ",
        "                        ",
        "                        ",
        "                        ",
        "                        ",
        "                        ",
        "                        ",
        "                        ",
        "                        "
      ],
      "terrain": { "#": "t_soil", 
      "u": "t_earth_ramp_up_low",
      "U": "t_earth_ramp_up_high"
	  }
    },
    "om_terrain": "hill_edge_north",
    "type": "mapgen",
    "weight": 100
  },
  {
    "method": "json",
    "object": {
      "predecessor_mapgen": "open_air",
      "rows": [
        "#####################UUU",
        "UU##########UUU###UUUuuu",
        "uuUUU####UUUuuuUUUuuu   ",
        "  uuuUUUUuuu   uuu      ",
        "     uuuu               ",
        "                        ",
        "                        ",
        "                        ",
        "                        ",
        "                        ",
        "                        ",
        "                        ",
        "                        ",
        "                        ",
        "                        ",
        "                        ",
        "                        ",
        "                        ",
        "                        ",
        "                        ",
        "                        ",
        "                        ",
        "                        ",
        "                        "
      ],
      "terrain": { "#": "t_floor", 
      "u": "t_earth_ramp_down_low",
      "U": "t_earth_ramp_down_high"
	  }
    },
    "om_terrain": "hill_edge_mid_north",
    "type": "mapgen",
    "weight": 100
  },
  {
    "method": "json",
    "object": {
      "predecessor_mapgen": "field",
      "rows": [
        "########################",
        "UU#########UUUU#######UU",
        "uuUU####UUUuuuuUUUUUUUuu",
        "  uuUUUUuuu    uuuuuuu  ",
        "    uuuu                ",
        "                        ",
        "                        ",
        "                        ",
        "                        ",
        "                        ",
        "                        ",
        "                        ",
        "                        ",
        "                        ",
        "                        ",
        "                        ",
        "                        ",
        "                        ",
        "                        ",
        "                        ",
        "                        ",
        "                        ",
        "                        ",
        "                        "
      ],
      "terrain": { "#": "t_soil", 
      "u": "t_earth_ramp_up_low",
      "U": "t_earth_ramp_up_high"
	  }
    },
    "om_terrain": "hill_edge2",
    "type": "mapgen",
    "weight": 100
  },
  {
    "method": "json",
    "object": {
      "predecessor_mapgen": "field",
      "rows": [
        "U######################U",
        "uUU##################UUu",
        " uuUUUUUU#########UUUuu ",
        "   uuuuuuUUUU###UUuuu   ",
        "         uuuuUUUuu      ",
        "             uuu        ",
        "                        ",
        "                        ",
        "                        ",
        "                        ",
        "                        ",
        "                        ",
        "                        ",
        "                        ",
        "                        ",
        "                        ",
        "                        ",
        "                        ",
        "                        ",
        "                        ",
        "                        ",
        "                        ",
        "                        ",
        "                        "
      ],
      "terrain": { "#": "t_soil", 
      "u": "t_earth_ramp_up_low",
      "U": "t_earth_ramp_up_high"
	  }
    },
    "om_terrain": "hill_edge2",
    "type": "mapgen",
    "weight": 100
  },
  {
    "method": "json",
    "object": {
      "predecessor_mapgen": "field",
      "rows": [
        "U###########UUU#########",
        "uUUUU######UuuuUU#######",
        " uuuuUUUUUUu   uuUU#####",
        "     uuuuuu       uuU###",
        "                   uU###",
        "                    uU##",
        "                    uU##",
        "                     uU#",
        "                     uU#",
        "                     uU#",
        "                     uU#",
        "                      uU",
        "                      uU",
        "                     uU#",
        "                     uU#",
        "                    uU##",
        "                    uU##",
        "                   uU###",
        "                   uU###",
        "                   uU###",
        "                    uU##",
        "                    uU##",
        "                     uU#",
        "                     uU#"
      ],
      "terrain": { "#": "t_soil", 
      "u": "t_earth_ramp_up_low",
      "U": "t_earth_ramp_up_high"
	  }
    },
    "om_terrain": "hill_corner",
    "type": "mapgen",
    "weight": 100
  },
  {
    "method": "json",
    "object": {
      "predecessor_mapgen": "field",
      "rows": [
        "U#######################",
        "uUU#####################",
        " uuUU#########UUUU######",
        "   uuUUU###UUUuuuuUU####",
        "     uuuUUUuuu    uuU###",
        "                    uU##",
        "                    uU##",
        "                    uU##",
        "                     uU#",
        "                     uU#",
        "                     uU#",
        "                     uU#",
        "                      uU",
        "                      uU",
        "                     uU#",
        "                    uU##",
        "                    uU##",
        "                     uU#",
        "                     uU#",
        "                     uU#",
        "                    uU##",
        "                    uU##",
        "                    uU##",
        "                     uU#"
      ],
      "terrain": { "#": "t_soil", 
      "u": "t_earth_ramp_up_low",
      "U": "t_earth_ramp_up_high"
	  }
    },
    "om_terrain": "hill_corner",
    "type": "mapgen",
    "weight": 100
  },
  {
    "method": "json",
    "object": {
      "predecessor_mapgen": "field",
      "rows": [
        "#Uu                  uU#",
        "#Uu                  uU#",
        "##Uu                uU##",
        "##Uu                uU##",
        "##Uu                uU##",
        "###Uu              uU###",
        "###Uu              uU###",
        "####Uu             uU###",
        "####Uu             uU###",
        "####Uu             uU###",
        "####Uu             uU###",
        "####Uu            uU####",
        "###Uu             uU####",
        "###Uu             uU####",
        "###Uu             uU####",
        "##Uu              uU####",
        "##Uu              uU####",
        "##Uu               uU###",
        "##Uu               uU###",
        "##Uu               uU###",
        "##Uu                uU##",
        "#Uu                 uU##",
        "#Uu                  uU#",
        "#Uu                  uU#"
      ],
      "terrain": { "#": "t_soil", 
      "u": "t_earth_ramp_up_low",
      "U": "t_earth_ramp_up_high"
	  }
    },
    "om_terrain": "hill_2way",
    "type": "mapgen",
    "weight": 100
  },
  {
    "method": "json",
    "object": {
      "predecessor_mapgen": "field",
      "rows": [
        "########################",
        "########################",
        "########################",
        "########################",
        "########################",
        "########################",
        "########################",
        "########################",
        "########################",
        "########################",
        "########################",
        "########################",
        "########################",
        "########################",
        "#########UUUUUU#########",
        "######UUUuuuuuuUUUU#####",
        "####UUuuu      uuuuUU###",
        "####Uu             uU###",
        "###Uu               uU##",
        "###Uu               uU##",
        "###Uu               uU##",
        "##Uu                 uU#",
        "##Uu                 uU#",
        "##Uu                 uU#"
      ],
      "terrain": { "#": "t_soil", 
      "u": "t_earth_ramp_up_low",
      "U": "t_earth_ramp_up_high"
	  }
    },
    "om_terrain": "hill_3way",
    "type": "mapgen",
    "weight": 100
  },
  {
    "method": "json",
    "object": { "predecessor_mapgen": "open_air" },
    "om_terrain": "hill_air",
    "type": "mapgen",
    "weight": 100
  },
  {
    "method": "json",
    "object": { "predecessor_mapgen": "open_air" },
    "om_terrain": "hill_air_1",
    "type": "mapgen",
    "weight": 100
  },
  {
    "method": "json",
    "object": { "predecessor_mapgen": "solid_earth" },
    "om_terrain": "hill",
    "type": "mapgen",
    "weight": 100
  },
  {
    "method": "json",
    "object": {
      "predecessor_mapgen": "field",
      "rows": [
        "#                     ##",
        "####         ###   #####",
        "#######    #############",
        "########################",
        "########################",
        "########################",
        "########################",
        "########################",
        "########################",
        "########################",
        "########################",
        "########################",
        "########################",
        "########################",
        "########################",
        "########################",
        "########################",
        "########################",
        "########################",
        "########################",
        "########################",
        "########################",
        "########################",
        "########################"
      ],
      "terrain": { "#": "t_soil" }
    },
    "om_terrain": "valley_edge",
    "type": "mapgen",
    "weight": 100
  },
  {
    "method": "json",
    "object": {
      "predecessor_mapgen": "field",
      "rows": [
        "##                    ##",
        "#####      ####     ####",
        "########################",
        "########################",
        "########################",
        "########################",
        "########################",
        "########################",
        "########################",
        "########################",
        "########################",
        "########################",
        "########################",
        "########################",
        "########################",
        "########################",
        "########################",
        "########################",
        "########################",
        "########################",
        "########################",
        "########################",
        "########################",
        "########################"
      ],
      "terrain": { "#": "t_soil" }
    },
    "om_terrain": "valley_edge",
    "type": "mapgen",
    "weight": 100
  },
  {
    "method": "json",
    "object": {
      "predecessor_mapgen": "field",
      "rows": [
        "#                    ###",
        "#####             ######",
        "########      ##########",
        "########################",
        "########################",
        "########################",
        "########################",
        "########################",
        "########################",
        "########################",
        "########################",
        "########################",
        "########################",
        "########################",
        "########################",
        "########################",
        "########################",
        "########################",
        "########################",
        "########################",
        "########################",
        "########################",
        "########################",
        "########################"
      ],
      "terrain": { "#": "t_soil" }
    },
    "om_terrain": "valley_edge",
    "type": "mapgen",
    "weight": 100
  },
  {
    "method": "json",
    "object": {
      "predecessor_mapgen": "field",
      "rows": [
        "                        ",
        "###                     ",
        "#####         ####      ",
        "########   #########    ",
        "#####################   ",
        "######################  ",
        "######################  ",
        "####################### ",
        "####################### ",
        "####################### ",
        "########################",
        "########################",
        "########################",
        "####################### ",
        "####################### ",
        "######################  ",
        "######################  ",
        "####################### ",
        "####################### ",
        "####################### ",
        "######################  ",
        "######################  ",
        "######################  ",
        "######################  "
      ],
      "terrain": { "#": "t_soil" }
    },
    "om_terrain": "valley_corner",
    "type": "mapgen",
    "weight": 100
  },
  {
    "method": "json",
    "object": {
      "predecessor_mapgen": "field",
      "rows": [
        "            ###         ",
        "####      #######       ",
        "###################     ",
        "#####################   ",
        "#####################   ",
        "######################  ",
        "######################  ",
        "######################  ",
        "####################### ",
        "####################### ",
        "####################### ",
        "####################### ",
        "####################### ",
        "######################  ",
        "######################  ",
        "######################  ",
        "######################  ",
        "#####################   ",
        "#####################   ",
        "#####################   ",
        "######################  ",
        "######################  ",
        "####################### ",
        "####################### "
      ],
      "terrain": { "#": "t_soil" }
    },
    "om_terrain": "valley_corner",
    "type": "mapgen",
    "weight": 100
  },
  {
    "method": "json",
    "object": {
      "predecessor_mapgen": "field",
      "rows": [
        "  ##################### ",
        "  ####################  ",
        "  ####################  ",
        "  ####################  ",
        "   ##################   ",
        "   ##################   ",
        "    #################   ",
        "    #################   ",
        "    #################   ",
        "    ################    ",
        "    ################    ",
        "    ################    ",
        "   #################    ",
        "   #################    ",
        "   #################    ",
        "   #################    ",
        "   ##################   ",
        "   ##################   ",
        "   ##################   ",
        "  ###################   ",
        "  ###################   ",
        "  ###################   ",
        " #####################  ",
        " #####################  "
      ],
      "terrain": { "#": "t_soil" }
    },
    "om_terrain": "valley_2way",
    "type": "mapgen",
    "weight": 100
  },
  {
    "method": "json",
    "object": {
      "predecessor_mapgen": "field",
      "rows": [
        "                        ",
        "                        ",
        "                        ",
        "                        ",
        "                        ",
        "                        ",
        "                        ",
        "                        ",
        "                        ",
        "                        ",
        "                        ",
        "                        ",
        "                        ",
        "                        ",
        "         ######         ",
        "      #############     ",
        "    #################   ",
        "    #################   ",
        "   ###################  ",
        "   ###################  ",
        "   ###################  ",
        "  ##################### ",
        "  ##################### ",
        "  ##################### "
      ],
      "terrain": { "#": "t_soil" }
    },
    "om_terrain": "valley_3way",
    "type": "mapgen",
    "weight": 100
  },
  {
    "method": "json",
    "object": { "fill_ter": "t_open_air" },
    "om_terrain": "valley_air",
    "type": "mapgen",
    "weight": 100
  },
  {
    "method": "json",
    "object": { "fill_ter": "t_open_air" },
    "om_terrain": "valley_air_surface",
    "type": "mapgen",
    "weight": 100
  }
]
