[
  {
    "type": "palette",
    "id": "hill_middle_palette",
    "terrain": {
      "#": "t_inner_hill",
      "u": "t_grass_slope_up_low",
      "U": "t_grass_slope_up_high",
      "o": "t_inner_hill",
      "O": "t_inner_hill"
    }
  },
  {
    "type": "palette",
    "id": "hill_bottom_palette",
    "terrain": {
      "#": "t_inner_hill",
      "u": "t_grass_slope_down_low",
      "U": "t_grass_slope_down_high",
      "o": "t_grass_slope_up_low",
      "O": "t_grass_slope_up_high"
    }
  },
  {
    "type": "palette",
    "id": "hill_top_palette",
    "terrain": { "#": "t_grass", "u": "t_open_air", "U": "t_open_air", "o": "t_grass_slope_down_low", "O": "t_grass_slope_down_high" }
  },
  {
    "method": "json",
    "object": {
      "rows": [
        "........................",
        "........................",
        "........................",
        "........................",
        "........................",
        "........................",
        "........................",
        "........................",
        "........................",
        "........................",
        "........................",
        "........................",
        "........................",
        "........................",
        "........................",
        "........................",
        "........................",
        "........................",
        "........................",
        "........................",
        "........................",
        "........................",
        "........................",
        "........................"
      ],
      "terrain": { ".": "t_inner_hill" }
    },
    "om_terrain": "hill",
    "type": "mapgen",
    "weight": 100
  },
  {
    "method": "json",
    "object": {
      "predecessor_mapgen": "field",
      "rows": [
        "O####################OOO",
        "oO##########OOO###OOOooo",
        " oOOO####OOOoooOOOooo   ",
        "  oooOOOOooo   ooo      ",
        "     oooo               ",
        "                        ",
        "                        ",
        "                        ",
        "                        ",
        "                        ",
        "                        ",
        "                        ",
        "                        ",
        "                        ",
        "                        ",
        "                        ",
        "                        ",
        "                        ",
        "                        ",
        "                        ",
        "                        ",
        "                        ",
        "                        ",
        "                        "
      ],
      "palettes": [ "hill_bottom_palette" ],
      "flags": [ "ERASE_ALL_BEFORE_PLACING_TERRAIN" ]
    },
    "om_terrain": "hill_b_edge_1",
    "type": "mapgen",
    "weight": 100
  },
  {
    "method": "json",
    "object": {
      "predecessor_mapgen": "open_air",
      "rows": [
        "O####################OOO",
        "oO##########OOO###OOOooo",
        " oOOO####OOOoooOOOooo   ",
        "  oooOOOOooo   ooo      ",
        "     oooo               ",
        "                        ",
        "                        ",
        "                        ",
        "                        ",
        "                        ",
        "                        ",
        "                        ",
        "                        ",
        "                        ",
        "                        ",
        "                        ",
        "                        ",
        "                        ",
        "                        ",
        "                        ",
        "                        ",
        "                        ",
        "                        ",
        "                        "
      ],
      "palettes": [ "hill_top_palette" ],
      "flags": [ "ERASE_ALL_BEFORE_PLACING_TERRAIN" ]
    },
    "om_terrain": "hill_t_edge_1",
    "type": "mapgen",
    "weight": 100
  },
  {
    "method": "json",
    "object": {
      "predecessor_mapgen": "field",
      "rows": [
        "O######################O",
        "oO#########OOOO#######Oo",
        " oOO####OOOooooOOOOOOOo ",
        "  ooOOOOooo    ooooooo  ",
        "    oooo                ",
        "                        ",
        "                        ",
        "                        ",
        "                        ",
        "                        ",
        "                        ",
        "                        ",
        "                        ",
        "                        ",
        "                        ",
        "                        ",
        "                        ",
        "                        ",
        "                        ",
        "                        ",
        "                        ",
        "                        ",
        "                        ",
        "                        "
      ],
      "palettes": [ "hill_bottom_palette" ],
      "flags": [ "ERASE_ALL_BEFORE_PLACING_TERRAIN" ]
    },
    "om_terrain": "hill_b_edge_2",
    "type": "mapgen",
    "weight": 100
  },
  {
    "method": "json",
    "object": {
      "predecessor_mapgen": "open_air",
      "rows": [
        "O######################O",
        "oO#########OOOO#######Oo",
        " oOO####OOOooooOOOOOOOo ",
        "  ooOOOOooo    ooooooo  ",
        "    oooo                ",
        "                        ",
        "                        ",
        "                        ",
        "                        ",
        "                        ",
        "                        ",
        "                        ",
        "                        ",
        "                        ",
        "                        ",
        "                        ",
        "                        ",
        "                        ",
        "                        ",
        "                        ",
        "                        ",
        "                        ",
        "                        ",
        "                        "
      ],
      "palettes": [ "hill_top_palette" ],
      "flags": [ "ERASE_ALL_BEFORE_PLACING_TERRAIN" ]
    },
    "om_terrain": "hill_t_edge_2",
    "type": "mapgen",
    "weight": 100
  },
  {
    "method": "json",
    "object": {
      "predecessor_mapgen": "field",
      "rows": [
        "O######################O",
        "oOO##################OOo",
        " ooOOOOOO#########OOOoo ",
        "   ooooooOOOO###OOooo   ",
        "         ooooOOOoo      ",
        "             ooo        ",
        "                        ",
        "                        ",
        "                        ",
        "                        ",
        "                        ",
        "                        ",
        "                        ",
        "                        ",
        "                        ",
        "                        ",
        "                        ",
        "                        ",
        "                        ",
        "                        ",
        "                        ",
        "                        ",
        "                        ",
        "                        "
      ],
      "palettes": [ "hill_bottom_palette" ],
      "flags": [ "ERASE_ALL_BEFORE_PLACING_TERRAIN" ]
    },
    "om_terrain": "hill_b_edge_3",
    "type": "mapgen",
    "weight": 100
  },
  {
    "method": "json",
    "object": {
      "predecessor_mapgen": "open_air",
      "rows": [
        "O######################O",
        "oOO##################OOo",
        " ooOOOOOO#########OOOoo ",
        "   ooooooOOOO###OOooo   ",
        "         ooooOOOoo      ",
        "             ooo        ",
        "                        ",
        "                        ",
        "                        ",
        "                        ",
        "                        ",
        "                        ",
        "                        ",
        "                        ",
        "                        ",
        "                        ",
        "                        ",
        "                        ",
        "                        ",
        "                        ",
        "                        ",
        "                        ",
        "                        ",
        "                        "
      ],
      "palettes": [ "hill_top_palette" ],
      "flags": [ "ERASE_ALL_BEFORE_PLACING_TERRAIN" ]
    },
    "om_terrain": "hill_t_edge_3",
    "type": "mapgen",
    "weight": 100
  },
  {
    "method": "json",
    "object": {
      "predecessor_mapgen": "field",
      "rows": [
        "O#########OOO###########",
        "oOO######OoooOO#########",
        " ooOOOOOOo   ooOO#######",
        "   oooooo      ooOO#####",
        "                 ooOO###",
        "                   oO###",
        "                   oO###",
        "                    oO##",
        "                    oO##",
        "                     oO#",
        "                     oO#",
        "                     oO#",
        "                     oO#",
        "                      oO",
        "                      oO",
        "                     oO#",
        "                     oO#",
        "                    oO##",
        "                    oO##",
        "                   oO###",
        "                    oO##",
        "                    oO##",
        "                     oO#",
        "                      oO"
      ],
      "palettes": [ "hill_bottom_palette" ],
      "flags": [ "ERASE_ALL_BEFORE_PLACING_TERRAIN" ]
    },
    "om_terrain": "hill_b_corner_1",
    "type": "mapgen",
    "weight": 100
  },
  {
    "method": "json",
    "object": {
      "predecessor_mapgen": "open_air",
      "rows": [
        "O#########OOO###########",
        "oOO######OoooOO#########",
        " ooOOOOOOo   ooOO#######",
        "   oooooo      ooOO#####",
        "                 ooOO###",
        "                   oO###",
        "                   oO###",
        "                    oO##",
        "                    oO##",
        "                     oO#",
        "                     oO#",
        "                     oO#",
        "                     oO#",
        "                      oO",
        "                      oO",
        "                     oO#",
        "                     oO#",
        "                    oO##",
        "                    oO##",
        "                   oO###",
        "                    oO##",
        "                    oO##",
        "                     oO#",
        "                      oO"
      ],
      "palettes": [ "hill_top_palette" ],
      "flags": [ "ERASE_ALL_BEFORE_PLACING_TERRAIN" ]
    },
    "om_terrain": "hill_t_corner_1",
    "type": "mapgen",
    "weight": 100
  },
  {
    "method": "json",
    "object": {
      "predecessor_mapgen": "field",
      "rows": [
        "O#######################",
        "oOO#####################",
        " ooOO#######OOOO########",
        "   ooOOO#OOOooooOO######",
        "     oooOooo    ooOO####",
        "        o         ooO###",
        "                   oO###",
        "                    oO##",
        "                    oO##",
        "                    oO##",
        "                     oO#",
        "                     oO#",
        "                     oO#",
        "                     oO#",
        "                      oO",
        "                      oO",
        "                     oO#",
        "                    oO##",
        "                    oO##",
        "                     oO#",
        "                     oO#",
        "                     oO#",
        "                    oO##",
        "                      oO"
      ],
      "palettes": [ "hill_bottom_palette" ],
      "flags": [ "ERASE_ALL_BEFORE_PLACING_TERRAIN" ]
    },
    "om_terrain": "hill_b_corner_2",
    "type": "mapgen",
    "weight": 100
  },
  {
    "method": "json",
    "object": {
      "predecessor_mapgen": "open_air",
      "rows": [
        "O#######################",
        "oOO#####################",
        " ooOO#######OOOO########",
        "   ooOOO#OOOooooOO######",
        "     oooOooo    ooOO####",
        "        o         ooO###",
        "                   oO###",
        "                    oO##",
        "                    oO##",
        "                    oO##",
        "                     oO#",
        "                     oO#",
        "                     oO#",
        "                     oO#",
        "                      oO",
        "                      oO",
        "                     oO#",
        "                    oO##",
        "                    oO##",
        "                     oO#",
        "                     oO#",
        "                     oO#",
        "                    oO##",
        "                      oO"
      ],
      "palettes": [ "hill_top_palette" ],
      "flags": [ "ERASE_ALL_BEFORE_PLACING_TERRAIN" ]
    },
    "om_terrain": "hill_t_corner_2",
    "type": "mapgen",
    "weight": 100
  },
  {
    "method": "json",
    "object": {
      "predecessor_mapgen": "field",
      "rows": [
        "Oo                    oO",
        "Oo                    oO",
        "#Oo                  oO#",
        "#Oo                  oO#",
        "#Oo                  oO#",
        "##Oo                oO##",
        "##Oo                oO##",
        "###Oo               oO##",
        "###Oo               oO##",
        "###Oo               oO##",
        "###Oo               oO##",
        "###Oo              oO###",
        "##Oo               oO###",
        "##Oo               oO###",
        "##Oo               oO###",
        "#Oo                oO###",
        "#Oo                oO###",
        "#Oo                 oO##",
        "#Oo                 oO##",
        "#Oo                 oO##",
        "#Oo                  oO#",
        "Oo                   oO#",
        "Oo                    oO",
        "Oo                    oO"
      ],
      "palettes": [ "hill_bottom_palette" ],
      "flags": [ "ERASE_ALL_BEFORE_PLACING_TERRAIN" ]
    },
    "om_terrain": "hill_2way_b",
    "type": "mapgen",
    "weight": 100
  },
  {
    "method": "json",
    "object": {
      "predecessor_mapgen": "open_air",
      "rows": [
        "Oo                    oO",
        "Oo                    oO",
        "#Oo                  oO#",
        "#Oo                  oO#",
        "#Oo                  oO#",
        "##Oo                oO##",
        "##Oo                oO##",
        "###Oo               oO##",
        "###Oo               oO##",
        "###Oo               oO##",
        "###Oo               oO##",
        "###Oo              oO###",
        "##Oo               oO###",
        "##Oo               oO###",
        "##Oo               oO###",
        "#Oo                oO###",
        "#Oo                oO###",
        "#Oo                 oO##",
        "#Oo                 oO##",
        "#Oo                 oO##",
        "#Oo                  oO#",
        "Oo                   oO#",
        "Oo                    oO",
        "Oo                    oO"
      ],
      "palettes": [ "hill_top_palette" ],
      "flags": [ "ERASE_ALL_BEFORE_PLACING_TERRAIN" ]
    },
    "om_terrain": "hill_2way_t",
    "type": "mapgen",
    "weight": 100
  },
  {
    "method": "json",
    "object": {
      "predecessor_mapgen": "field",
      "rows": [
        "########################",
        "########################",
        "########################",
        "########################",
        "########################",
        "########################",
        "########################",
        "########################",
        "########################",
        "########################",
        "########################",
        "########################",
        "#########OOOOO##########",
        "######OOOoooooOOOO######",
        "#####Oooo     ooooOO####",
        "###OOo            oOO###",
        "##Oo                oO##",
        "##Oo                oO##",
        "#Oo                  oO#",
        "#Oo                  oO#",
        "#Oo                  oO#",
        "Oo                    oO",
        "Oo                    oO",
        "Oo                    oO"
      ],
      "palettes": [ "hill_bottom_palette" ],
      "flags": [ "ERASE_ALL_BEFORE_PLACING_TERRAIN" ]
    },
    "om_terrain": "hill_3way_b",
    "type": "mapgen",
    "weight": 100
  },
  {
    "method": "json",
    "object": {
      "predecessor_mapgen": "open_air",
      "rows": [
        "########################",
        "########################",
        "########################",
        "########################",
        "########################",
        "########################",
        "########################",
        "########################",
        "########################",
        "########################",
        "########################",
        "########################",
        "#########OOOOO##########",
        "######OOOoooooOOOO######",
        "#####Oooo     ooooOO####",
        "###OOo            oOO###",
        "##Oo                oO##",
        "##Oo                oO##",
        "#Oo                  oO#",
        "#Oo                  oO#",
        "#Oo                  oO#",
        "Oo                    oO",
        "Oo                    oO",
        "Oo                    oO"
      ],
      "palettes": [ "hill_top_palette" ],
      "flags": [ "ERASE_ALL_BEFORE_PLACING_TERRAIN" ]
    },
    "om_terrain": "hill_3way_t",
    "type": "mapgen",
    "weight": 100
  },
  {
    "method": "json",
    "object": { "predecessor_mapgen": "open_air" },
    "om_terrain": "hill_air",
    "type": "mapgen",
    "weight": 100
  },
  {
    "method": "json",
    "object": { "predecessor_mapgen": "open_air" },
    "om_terrain": "hill_air_1",
    "type": "mapgen",
    "weight": 100
  },
  {
    "method": "json",
    "object": { "predecessor_mapgen": "field" },
    "om_terrain": "hill_top",
    "type": "mapgen",
    "weight": 100
  },
  {
    "method": "json",
    "object": { "predecessor_mapgen": "field" },
    "om_terrain": "valley_floor",
    "type": "mapgen",
    "weight": 100
  },
  {
    "method": "json",
    "object": {
      "predecessor_mapgen": "open_air",
      "rows": [
        "u                     uu",
        "Uuuu         uuu   uuuUU",
        "oUUUuuu    uuUUUuuuUUUoo",
        "OoooUUUuuuuUUoooUUUoooOO",
        "#OOOoooUUUUooOOOoooOOO##",
        "####OOOooooOO###OOO#####",
        "#######OOOO#############",
        "########################",
        "########################",
        "########################",
        "########################",
        "########################",
        "########################",
        "########################",
        "########################",
        "########################",
        "########################",
        "########################",
        "########################",
        "########################",
        "########################",
        "########################",
        "########################",
        "########################"
      ],
      "palettes": [ "hill_top_palette" ],
      "flags": [ "ERASE_ALL_BEFORE_PLACING_TERRAIN" ]
    },
    "om_terrain": "valley_t_edge_1",
    "type": "mapgen",
    "weight": 100
  },
  {
    "method": "json",
    "object": {
      "predecessor_mapgen": "open_air",
      "rows": [
        "u                     uu",
        "Uuuu         uuu   uuuUU",
        "oUUUuuu    uuUUUuuuUUUoo",
        "OoooUUUuuuuUUoooUUUoooOO",
        "#OOOoooUUUUooOOOoooOOO##",
        "####OOOooooOO###OOO#####",
        "#######OOOO#############",
        "########################",
        "########################",
        "########################",
        "########################",
        "########################",
        "########################",
        "########################",
        "########################",
        "########################",
        "########################",
        "########################",
        "########################",
        "########################",
        "########################",
        "########################",
        "########################",
        "########################"
      ],
      "palettes": [ "hill_middle_palette" ],
      "flags": [ "ERASE_ALL_BEFORE_PLACING_TERRAIN" ]
    },
    "om_terrain": "valley_m_edge_1",
    "type": "mapgen",
    "weight": 100
  },
  {
    "method": "json",
    "object": {
      "predecessor_mapgen": "field",
      "rows": [
        "u                     uu",
        "Uuuu         uuu   uuuUU",
        "oUUUuuu    uuUUUuuuUUUoo",
        "OoooUUUuuuuUUoooUUUoooOO",
        "#OOOoooUUUUooOOOoooOOO##",
        "####OOOooooOO###OOO#####",
        "#######OOOO#############",
        "########################",
        "########################",
        "########################",
        "########################",
        "########################",
        "########################",
        "########################",
        "########################",
        "########################",
        "########################",
        "########################",
        "########################",
        "########################",
        "########################",
        "########################",
        "########################",
        "########################"
      ],
      "palettes": [ "hill_bottom_palette" ],
      "flags": [ "ERASE_ALL_BEFORE_PLACING_TERRAIN" ]
    },
    "om_terrain": "valley_b_edge_1",
    "type": "mapgen",
    "weight": 100
  },
  {
    "method": "json",
    "object": {
      "predecessor_mapgen": "field",
      "rows": [
        "##                    ##",
        "#####      ####     ####",
        "########################",
        "########################",
        "########################",
        "########################",
        "########################",
        "########################",
        "########################",
        "########################",
        "########################",
        "########################",
        "########################",
        "########################",
        "########################",
        "########################",
        "########################",
        "########################",
        "########################",
        "########################",
        "########################",
        "########################",
        "########################",
        "########################"
      ],
      "terrain": { "#": "t_soil" }
    },
    "om_terrain": "valley_edge",
    "type": "mapgen",
    "weight": 100
  },
  {
    "method": "json",
    "object": {
      "predecessor_mapgen": "field",
      "rows": [
        "#                    ###",
        "#####             ######",
        "########      ##########",
        "########################",
        "########################",
        "########################",
        "########################",
        "########################",
        "########################",
        "########################",
        "########################",
        "########################",
        "########################",
        "########################",
        "########################",
        "########################",
        "########################",
        "########################",
        "########################",
        "########################",
        "########################",
        "########################",
        "########################",
        "########################"
      ],
      "terrain": { "#": "t_soil" }
    },
    "om_terrain": "valley_edge",
    "type": "mapgen",
    "weight": 100
  },
  {
    "method": "json",
    "object": {
      "predecessor_mapgen": "field",
      "rows": [
        "                        ",
        "###                     ",
        "#####         ####      ",
        "########   #########    ",
        "#####################   ",
        "######################  ",
        "######################  ",
        "####################### ",
        "####################### ",
        "####################### ",
        "########################",
        "########################",
        "########################",
        "####################### ",
        "####################### ",
        "######################  ",
        "######################  ",
        "####################### ",
        "####################### ",
        "####################### ",
        "######################  ",
        "######################  ",
        "######################  ",
        "######################  "
      ],
      "terrain": { "#": "t_soil" }
    },
    "om_terrain": "valley_corner",
    "type": "mapgen",
    "weight": 100
  },
  {
    "method": "json",
    "object": {
      "predecessor_mapgen": "field",
      "rows": [
        "            ###         ",
        "####      #######       ",
        "###################     ",
        "#####################   ",
        "#####################   ",
        "######################  ",
        "######################  ",
        "######################  ",
        "####################### ",
        "####################### ",
        "####################### ",
        "####################### ",
        "####################### ",
        "######################  ",
        "######################  ",
        "######################  ",
        "######################  ",
        "#####################   ",
        "#####################   ",
        "#####################   ",
        "######################  ",
        "######################  ",
        "####################### ",
        "####################### "
      ],
      "terrain": { "#": "t_soil" }
    },
    "om_terrain": "valley_corner",
    "type": "mapgen",
    "weight": 100
  },
  {
    "method": "json",
    "object": {
      "predecessor_mapgen": "field",
      "rows": [
        "  ##################### ",
        "  ####################  ",
        "  ####################  ",
        "  ####################  ",
        "   ##################   ",
        "   ##################   ",
        "    #################   ",
        "    #################   ",
        "    #################   ",
        "    ################    ",
        "    ################    ",
        "    ################    ",
        "   #################    ",
        "   #################    ",
        "   #################    ",
        "   #################    ",
        "   ##################   ",
        "   ##################   ",
        "   ##################   ",
        "  ###################   ",
        "  ###################   ",
        "  ###################   ",
        " #####################  ",
        " #####################  "
      ],
      "terrain": { "#": "t_soil" }
    },
    "om_terrain": "valley_2way",
    "type": "mapgen",
    "weight": 100
  },
  {
    "method": "json",
    "object": {
      "predecessor_mapgen": "field",
      "rows": [
        "                        ",
        "                        ",
        "                        ",
        "                        ",
        "                        ",
        "                        ",
        "                        ",
        "                        ",
        "                        ",
        "                        ",
        "                        ",
        "                        ",
        "                        ",
        "                        ",
        "         ######         ",
        "      #############     ",
        "    #################   ",
        "    #################   ",
        "   ###################  ",
        "   ###################  ",
        "   ###################  ",
        "  ##################### ",
        "  ##################### ",
        "  ##################### "
      ],
      "terrain": { "#": "t_soil" }
    },
    "om_terrain": "valley_3way",
    "type": "mapgen",
    "weight": 100
  },
  {
    "method": "json",
    "object": { "fill_ter": "t_open_air" },
    "om_terrain": "valley_air",
    "type": "mapgen",
    "weight": 100
  },
  {
    "method": "json",
    "object": { "fill_ter": "t_open_air" },
    "om_terrain": "valley_air_surface",
    "type": "mapgen",
    "weight": 100
  }
]
