[
  {
    "method": "json",
    "om_terrain": "city_wall_vertical_west",
    "type": "mapgen",
    "weight": 100,
    "object": {
      "fill_ter": "t_dirt",
      "rows": [
        "........SWWWWWWS,,,,,,,,",
        "........SWWWWWWS,,,,,,,,",
        "........SWWWWWWS,,,,,,,,",
        "........SWWWWWWS,,,,,,,,",
        "........SWWWWWWS,,,,,,,,",
        "........SWWWWWWS,,,,,,,,",
        "........SWWWWWWS,,,,,,,,",
        "........SWWWWWWS,,,,,,,,",
        "........SWWWWWWS,,,,,,,,",
        "........SWWWWWWS,,,,,,,,",
        "........SWWWWWWS,,,,,,,,",
        "........SWWWWWWS,,,,,,,,",
        "........SWWWWWWS,,,,,,,,",
        "........SWWWWWWS,,,,,,,,",
        "........SWWWWWWS,,,,,,,,",
        "........SWWWWWWS,,,,,,,,",
        "........SWWWWWWS,,,,,,,,",
        "........SWWWWWWS,,,,,,,,",
        "........SWWWWWWS,,,,,,,,",
        "........SWWWWWWS,,,,,,,,",
        "........SWWWWWWS,,,,,,,,",
        "........SWWWWWWS,,,,,,,,",
        "........SWWWWWWS,,,,,,,,",
        "........SWWWWWWS,,,,,,,,"
      ],
      "palettes": [ "city_building_palette" ]
    }
  },
  {
    "method": "json",
    "om_terrain": "gatehouse_city_wall",
    "type": "mapgen",
    "weight": 100,
    "object": {
      "fill_ter": "t_dirt",
      "rows": [
        ",,,                  ,,,",
        "srrrrrrrrrrrrrrrrrrrrrrs",
        "ssrrrrrrrrrrsrrrrrrrrrss",
        "srrrrrrrrrrsssrrrrrrrrrs",
        "srrrrrrrrrrrsrrrrrrrrrrs",
        "srrrrrrrrrrrsrrrrrrrrrrs",
        "srrrrrrrrrrrrrrrrrrrrrrs",
        "srrrrrrrrrrrrrrrrrrrrrrs",
        "srrrrrrrrrrrrrrrrrrrrrrs",
        "srrrrrrrrrrrrrrrrrrrrrrs",
        "srrrrrrrrrrrrrrrrrrrrrrs",
        "srrrrrrrrrrrrrrrrrrrrrrs",
        "srrrrrrrrrrrrrrrrrrrrrrs",
        "srrrrrrrrrrrrrrrrrrrrrrs",
        "srrrrrrrrrrrrrrrrrrrrrrs",
        "srrrrrrrrrrrrrrrrrrrrrrs",
        "srrrrrrrrrrrrrrrrrrrrrrs",
        "srrrrrrrrrrrrrrrrrrrrrrs",
        "srrrrrrrrrrrrrrrrrrrrrrs",
        "srrrrrrrrrrrrrrrrrrrrrrs",
        "srrrrrrrrrrrrrrrrrrrrrrs",
        "ssrrrrrrrrrrrrrrrrrrrrss",
        "srrrrrrrrrrrrrrrrrrrrrrs",
        ",,,                  ,,,"
      ],
      "palettes": [ "city_building_palette" ]
    }
  }
]
