[
  {
    "method": "json",
    "om_terrain": "city_wall_vertical_west_1",
    "type": "mapgen",
    "weight": 100,
    "object": {
      "fill_ter": "t_dirt",
      "rows": [
        "........SWWWWWWS,,,,,,,,",
        "........SWWWWWWS,,,,,,,,",
        "........SWWWWWWS,,,,,,,,",
        "........SWWWWWWS,,,,,,,,",
        "........SWWWWWWS,,,,,,,,",
        "........SWWWWWWS,,,,,,,,",
        "........SWWWWWWS,,,,,,,,",
        "........SWWWWWWS,,,,,,,,",
        "........SWWWWWWS,,,,,,,,",
        "........SWWWWWWS,,,,,,,,",
        "........SWWWWWWS,,,,,,,,",
        "........SWWWWWWS,,,,,,,,",
        "........SWWWWWWS,,,,,,,,",
        "........SWWWWWWS,,,,,,,,",
        "........SWWWWWWS,,,,,,,,",
        "........SWWWWWWS,,,,,,,,",
        "........SWWWWWWS,,,,,,,,",
        "........SWWWWWWS,,,,,,,,",
        "........SWWWWWWS,,,,,,,,",
        "........SWWWWWWS,,,,,,,,",
        "........SWWWWWWS,,,,,,,,",
        "........SWWWWWWS,,,,,,,,",
        "........SWWWWWWS,,,,,,,,",
        "........SWWWWWWS,,,,,,,,"
      ],
      "palettes": [ "city_walls_palette_west_1" ]
    }
  }
]
