[
  {
    "method": "json",
    "om_terrain": [ [ "city_wall_0" ], [ "city_wall_1" ], [ "city_wall_2" ] ],
    "type": "mapgen",
    "weight": 100,
    "object": {
      "fill_ter": "t_dirt",
      "rows": [
        "........SSSSSSSS,,,,,,,,",
        "........SSSSSSSS,,,,,,,,",
        "........SSSSSSSS,,,,,,,,",
        "........SSSSSSSS,,,,,,,,",
        "........SSSSSSSS,,,,,,,,",
        "........SSSSSSSS,,,,,,,,",
        "........SSSSSSSS,,,,,,,,",
        "........SSSSSSSS,,,,,,,,",
        "........SSSSSSSS,,,,,,,,",
        "........SSSSSSSS,,,,,,,,",
        "........SSSSSSSS,,,,,,,,",
        "........SSSSSSSS,,,,,,,,",
        "........SSSSSSSS,,,,,,,,",
        "........SSSSSSSS,,,,,,,,",
        "........SSSSSSSS,,,,,,,,",
        "........SSSSSSSS,,,,,,,,",
        "........SSSSSSSS,,,,,,,,",
        "........SSSSSSSS,,,,,,,,",
        "........SSSSSSSS,,,,,,,,",
        "........SSSSSSSS,,,,,,,,",
        "........SSSSSSSS,,,,,,,,",
        "........SSSSSSSS,,,,,,,,",
        "........SSSSSSSS,,,,,,,,",
        "........SSSSSSSS,,,,,,,,",
        "%%%%%%%%SSSSSSSS%%%%%%%%",
        "%%%%%%%%SSSSSSSS%%%%%%%%",
        "%%%%%%%%SSSSSSSS%%%%%%%%",
        "%%%%%%%%SSSSSSSS%%%%%%%%",
        "%%%%%%%%SSSSSSSS%%%%%%%%",
        "%%%%%%%%SSSSSSSS%%%%%%%%",
        "%%%%%%%%SSSSSSSS%%%%%%%%",
        "%%%%%%%%SSSSSSSS%%%%%%%%",
        "%%%%%%%%SSSSSSSS%%%%%%%%",
        "%%%%%%%%SSSSSSSS%%%%%%%%",
        "%%%%%%%%SSSSSSSS%%%%%%%%",
        "%%%%%%%%SSSSSSSS%%%%%%%%",
        "%%%%%%%%SSSSSSSS%%%%%%%%",
        "%%%%%%%%SSSSSSSS%%%%%%%%",
        "%%%%%%%%SSSSSSSS%%%%%%%%",
        "%%%%%%%%SSSSSSSS%%%%%%%%",
        "%%%%%%%%SSSSSSSS%%%%%%%%",
        "%%%%%%%%SSSSSSSS%%%%%%%%",
        "%%%%%%%%SSSSSSSS%%%%%%%%",
        "%%%%%%%%SSSSSSSS%%%%%%%%",
        "%%%%%%%%SSSSSSSS%%%%%%%%",
        "%%%%%%%%SSSSSSSS%%%%%%%%",
        "%%%%%%%%SSSSSSSS%%%%%%%%",
        "%%%%%%%%SSSSSSSS%%%%%%%%",
        "%%%%%%%%SWWWWWWW%%%%%%%%",
        "%%%%%%%%CWWWWWWW%%%%%%%%",
        "%%%%%%%%SWWWWWWW%%%%%%%%",
        "%%%%%%%%SWWWWWWW%%%%%%%%",
        "%%%%%%%%CWWWWWWW%%%%%%%%",
        "%%%%%%%%SWWWWWWW%%%%%%%%",
        "%%%%%%%%SWWWWWWW%%%%%%%%",
        "%%%%%%%%CWWWWWWW%%%%%%%%",
        "%%%%%%%%SWWWWWWW%%%%%%%%",
        "%%%%%%%%SWWWWWWW%%%%%%%%",
        "%%%%%%%%CWWWWWWW%%%%%%%%",
        "%%%%%%%%SWWWWWWW%%%%%%%%",
        "%%%%%%%%SWWWWWWW%%%%%%%%",
        "%%%%%%%%CWWWWWWW%%%%%%%%",
        "%%%%%%%%SWWWWWWW%%%%%%%%",
        "%%%%%%%%SWWWWWWW%%%%%%%%",
        "%%%%%%%%CWWWWWWW%%%%%%%%",
        "%%%%%%%%SWWWWWWW%%%%%%%%",
        "%%%%%%%%SWWWWWWW%%%%%%%%",
        "%%%%%%%%CWWWWWWW%%%%%%%%",
        "%%%%%%%%SWWWWWWW%%%%%%%%",
        "%%%%%%%%SWWWWWWW%%%%%%%%",
        "%%%%%%%%CWWWWWWW%%%%%%%%",
        "%%%%%%%%SWWWWWWW%%%%%%%%"
      ],
      "palettes": [ "city_walls_palette_1" ]
    }
  },
  {
    "method": "json",
    "om_terrain": "city_wall_corner_0",
    "type": "mapgen",
    "weight": 100,
    "object": {
      "fill_ter": "t_dirt",
      "rows": [
        "........................",
        "........................",
        "........................",
        "........................",
        "........................",
        "........................",
        "........................",
        "........................",
        "........SSSSSSSSSSSSSSSS",
        "........SSSSSSSSSSSSSSSS",
        "........SSSSSSSSSSSSSSSS",
        "........SSSSSSSSSSSSSSSS",
        "........SSSSSSSSSSSSSSSS",
        "........SSSSSSSSSSSSSSSS",
        "........SSSSSSSSSSSSSSSS",
        "........SSSSSSSSSSSSSSSS",
        "........SSSSSSSS,,,,,,,,",
        "........SSSSSSSS,,,,,,,,",
        "........SSSSSSSS,,,,,,,,",
        "........SSSSSSSS,,,,,,,,",
        "........SSSSSSSS,,,,,,,,",
        "........SSSSSSSS,,,,,,,,",
        "........SSSSSSSS,,,,,,,,",
        "........SSSSSSSS,,,,,,,,"
      ],
      "palettes": [ "city_walls_palette_1" ]
    }
  },
  {
    "method": "json",
    "om_terrain": "city_wall_corner_1",
    "type": "mapgen",
    "weight": 100,
    "object": {
      "fill_ter": "t_dirt",
      "rows": [
        "%%%%%%%%%%%%%%%%%%%%%%%%",
        "%%%%%%%%%%%%%%%%%%%%%%%%",
        "%%%%%%%%%%%%%%%%%%%%%%%%",
        "%%%%%%%%%%%%%%%%%%%%%%%%",
        "%%%%%%%%%%%%%%%%%%%%%%%%",
        "%%%%%%%%%%%%%%%%%%%%%%%%",
        "%%%%%%%%%%%%%%%%%%%%%%%%",
        "%%%%%%%%%%%%%%%%%%%%%%%%",
        "%%%%%%%%SSSSSSSSSSSSSSSS",
        "%%%%%%%%SSSSSSSSSSSSSSSS",
        "%%%%%%%%SSSSSSSSSSSSSSSS",
        "%%%%%%%%SSSSSSSSSSSSSSSS",
        "%%%%%%%%SSSSSSSSSSSSSSSS",
        "%%%%%%%%SSSSSSSSSSSSSSSS",
        "%%%%%%%%SSSSSSSSSSSSSSSS",
        "%%%%%%%%SSSSSSSSSSSSSSSS",
        "%%%%%%%%SSSSSSSS%%%%%%%%",
        "%%%%%%%%SSSSSSSS%%%%%%%%",
        "%%%%%%%%SSSSSSSS%%%%%%%%",
        "%%%%%%%%SSSSSSSS%%%%%%%%",
        "%%%%%%%%SSSSSSSS%%%%%%%%",
        "%%%%%%%%SSSSSSSS%%%%%%%%",
        "%%%%%%%%SSSSSSSS%%%%%%%%",
        "%%%%%%%%SSSSSSSS%%%%%%%%"
      ],
      "palettes": [ "city_walls_palette_1" ]
    }
  },
  {
    "method": "json",
    "om_terrain": "city_wall_corner_2",
    "type": "mapgen",
    "weight": 100,
    "object": {
      "fill_ter": "t_dirt",
      "rows": [
        "%%%%%%%%%%%%%%%%%%%%%%%%",
        "%%%%%%%%%%%%%%%%%%%%%%%%",
        "%%%%%%%%%%%%%%%%%%%%%%%%",
        "%%%%%%%%%%%%%%%%%%%%%%%%",
        "%%%%%%%%%%%%%%%%%%%%%%%%",
        "%%%%%%%%%%%%%%%%%%%%%%%%",
        "%%%%%%%%%%%%%%%%%%%%%%%%",
        "%%%%%%%%%%%%%%%%%%%%%%%%",
        "%%%%%%%%CSCSSCSSCSSCSSCS",
        "%%%%%%%%SWWWWWWWWWWWWWWW",
        "%%%%%%%%CWWWWWWWWWWWWWWW",
        "%%%%%%%%SWWWWWWWWWWWWWWW",
        "%%%%%%%%SWWWWWWWWWWWWWWW",
        "%%%%%%%%CWWWWWWWWWWWWWWW",
        "%%%%%%%%SWWWWWWWWWWWWWWW",
        "%%%%%%%%SWWWWWWWWWWWWWWW",
        "%%%%%%%%CWWWWWWW%%%%%%%%",
        "%%%%%%%%SWWWWWWW%%%%%%%%",
        "%%%%%%%%SWWWWWWW%%%%%%%%",
        "%%%%%%%%CWWWWWWW%%%%%%%%",
        "%%%%%%%%SWWWWWWW%%%%%%%%",
        "%%%%%%%%SWWWWWWW%%%%%%%%",
        "%%%%%%%%CWWWWWWW%%%%%%%%",
        "%%%%%%%%SWWWWWWW%%%%%%%%"
      ],
      "palettes": [ "city_walls_palette_1" ]
    }
  },
  {
    "method": "json",
    "om_terrain": "city_wall_tower_0",
    "type": "mapgen",
    "weight": 100,
    "object": {
      "fill_ter": "t_floor",
      "rows": [
        "........................",
        "........................",
        "........................",
        "...SSSSSSSSSSSSSSSSSS...",
        "...S================S...",
        "...S================S...",
        "...S================S...",
        "...S================S...",
        "...S================SSSS",
        "...S================SSSS",
        "...S================SSSS",
        "...S=======<<=======SSSS",
        "...S=======<<=======SSSS",
        "...S================SSSS",
        "...S================SSSS",
        "...S================SSSS",
        "...S================S<,,",
        "...S================+,,,",
        "...S================S,,,",
        "...S================S,,,",
        "...SSSSSSSSSSSSSSSSSS,,,",
        "........SSSSSSSS<,,,,,,,",
        "........SSSSSSSS,,,,,,,,",
        "........SSSSSSSS,,,,,,,,"
      ],
      "palettes": [ "city_walls_palette_1" ]
    }
  },
  {
    "method": "json",
    "om_terrain": "city_wall_tower_1",
    "type": "mapgen",
    "weight": 100,
    "object": {
      "fill_ter": "t_floor",
      "rows": [
        "%%%%%%%%%%%%%%%%%%%%%%%%",
        "%%%%%%%%%%%%%%%%%%%%%%%%",
        "%%%%%%%%%%%%%%%%%%%%%%%%",
        "%%%SSSSSSSSSSSSSSSSSS%%%",
        "%%%S================S%%%",
        "%%%S================S%%%",
        "%%%S================S%%%",
        "%%%S================S%%%",
        "%%%S================SSSS",
        "%%%S=======<<=======SSSS",
        "%%%S=======<<=======SSSS",
        "%%%S=======>>=======SSSS",
        "%%%S=======>>=======SSSS",
        "%%%S================SSSS",
        "%%%S================SSSS",
        "%%%S================SSSS",
        "%%%S================+><%",
        "%%%S================S%%%",
        "%%%S================S%%%",
        "%%%S================S%%%",
        "%%%SSSSSSSSSSSSSSSSSS%%%",
        "%%%%%%%%SSSSSSSS>%%%%%%%",
        "%%%%%%%%SSSSSSSS<%%%%%%%",
        "%%%%%%%%SSSSSSSS%%%%%%%%"
      ],
      "palettes": [ "city_walls_palette_1" ]
    }
  },
  {
    "method": "json",
    "om_terrain": "city_wall_tower_2",
    "type": "mapgen",
    "weight": 100,
    "object": {
      "fill_ter": "t_floor",
      "rows": [
        "%%%%%%%%%%%%%%%%%%%%%%%%",
        "%%%%%%%%%%%%%%%%%%%%%%%%",
        "%%%%%%%%%%%%%%%%%%%%%%%%",
        "%%%SSSSSSSSSSSSSSSSSS%%%",
        "%%%S================S%%%",
        "%%%S================S%%%",
        "%%%S================S%%%",
        "%%%S================S%%%",
        "%%%S================SSCS",
        "%%%S=======>>=======SWWW",
        "%%%S=======>>=======SWWW",
        "%%%S================+WWW",
        "%%%S================+WWW",
        "%%%S================SWWW",
        "%%%S================SWWW",
        "%%%S================SWWW",
        "%%%S================SW>%",
        "%%%S================S%%%",
        "%%%S================S%%%",
        "%%%S================S%%%",
        "%%%SSSSSSSS++SSSSSSSS%%%",
        "%%%%%%%%SWWWWWSWW%%%%%%%",
        "%%%%%%%%CWWWWWSW>%%%%%%%",
        "%%%%%%%%SWWWWWSW%%%%%%%%"
      ],
      "palettes": [ "city_walls_palette_1" ]
    }
  },
  {
    "method": "json",
    "om_terrain": "city_tower_1",
    "type": "mapgen",
    "weight": 100,
    "object": {
      "fill_ter": "t_floor",
      "rows": [
        "...S================S...",
        "...S================S...",
        "...S================S...",
        "...S================S...",
        "...S================S...",
        "...S================S...",
        "...S================S...",
        "...S================S...",
        "...S================S...",
        "...S================S...",
        "...S================S...",
        "...S================S...",
        "...S================S...",
        "...S================S...",
        "...S================S...",
        "...S================S...",
        "...SSSSSSSS++SSSSSSSS...",
        "........SWWWWWWS........",
        "........SWWWWWWS........",
        "........CWWWWWWC........",
        "........SWWWWWSS........",
        "........SWWWWWWS........",
        "........CWWWWWWC........",
        "........SWWWWWWS........"
      ],
      "palettes": [ "city_walls_palette_1" ]
    }
  },
  {
    "method": "json",
    "om_terrain": "city_gate_1",
    "type": "mapgen",
    "weight": 100,
    "object": {
      "fill_ter": "t_floor",
      "rows": [
        "...S================S...",
        "...S================S...",
        "...S================S...",
        "...SSSSSSSSSSSSSSSSSS...",
        "..........+.............",
        "..........+.............",
        "..........+.............",
        "..........+.............",
        "..........+.............",
        "..........+.............",
        "..........+.............",
        "..........+.............",
        "..........+.............",
        "..........+.............",
        "..........+.............",
        "..........+.............",
        "..........+.............",
        "..........+.............",
        "..........+.............",
        "..........+.............",
        "...SSSSSSSSSSSSSSSSSS...",
        "...S================S...",
        "...S================S...",
        "...S================S..."
      ],
      "palettes": [ "city_walls_palette_1" ]
    }
  }
]
